9
110000011
001000100
001101100
000111000
000000000
100000001
000101000
100111001
100010001